22222222222222222222
20000000000000000002
20000000000000000002
20000100000000100002
20000100000000100002
20011211000011211002
20000100000000100002
20000100000000100002
20000000000000000002
20000000000000000002
20022222000022222002
20020000000000002002
20000000000000000002
20000000111100000002
20000000000000000002
20020000000000002002
20022222000022222002
20000000000000000002
20000000000000000002
22222222222222222222